0000000000000000001
0000000000000000000
0000000000000000000
0000000000000000000
1000000000000000000
1000333333300000000
1000000000000000000
1000000000000000000
1000111111100000000
1000000000000000000
1000000000000000000
1000000000000000000
1000000000000000000
1000000000000000000
1000000000000000000
