9 9
011011111
101011111
111011111
111011111
111011111
111011111
111011111
100011111
101011111